#...................
.#...@..............
..#..@..............
...#.@@@@@..........
...#.....@..........
....#@@@@@..........
....#@...@@@@.......
....#@...@@@@.@@....
.....#.@@@..........
.....#@@@@..........
.....#@@@@@@@@@@....
.....#@........@....
....#.@........@....
@@.#@@@........@....
....#.@.............
.....#@........@@...
.....#@@@@@@@@@@@...
......#.............
.......###..........
..........#.........
