#..#.#..............
.##.#@#.............
.....@.###..........
.....@@@@@#.........
.........@.#........
.....@@@@@..#.......
.....@...@@@@#......
.....@...@@@@#@@....
.......@@@....#.....
......@@@@.....#....
......@@@@@@@@@@#...
......@........@#...
......@........@#...
@@..@@@........@#...
......@..........#..
......@........@@#..
......@@@@@@@@@@@.#.
..................#.
..................#.
...................#
